{
  "levels": {
    "editor": [
      [3, 3, 3, 3, 3],
      [3, 4, 2, 2, 3],
      [3, 2, 2, 2, 3],
      [3, 3, 3, 3, 3]
    ],
    "1": [
      [1, 2, 3, 4, 2],
      [4, 3, 2, 1, 3],
      [1, 2, 3, 4, 4],
      [4, 3, 2, 1, 1]
    ],
    "2": [
      [2, 2, 2, 2, 2, 2, 2, 2, 2, 2, 2, 2],
      [2, 7, 7, 7, 7, 3, 3, 3, 3, 3, 3, 2],
      [2, 3, 7, 3, 3, 3, 3, 3, 3, 3, 3, 2],
      [2, 3, 3, 3, 3, 3, 3, 3, 3, 6, 3, 2],
      [2, 3, 3, 3, 3, 3, 3, 3, 6, 3, 3, 2],
      [2, 2, 2, 2, 3, 3, 3, 3, 3, 3, 3, 2],
      [2, 3, 3, 3, 3, 3, 3, 3, 3, 3, 3, 2],
      [2, 3, 4, 3, 3, 3, 3, 3, 3, 2, 2, 2],
      [2, 3, 3, 3, 3, 3, 3, 8, 3, 3, 3, 2],
      [2, 3, 5, 3, 3, 3, 8, 8, 8, 3, 3, 2],
      [2, 3, 3, 3, 3, 3, 3, 8, 3, 3, 3, 2],
      [2, 2, 2, 2, 2, 2, 2, 2, 2, 2, 2, 2]
    ]
  }
}
